|--------|
|--I--@--|
|--------|
|--------|
|-------||
